!plr
4,4,90

!map
[1,1,1,1,1,1,1,1],
[1,0,0,0,0,0,0,1],
[1,0,0,0,0,0,0,1],
[1,0,0,0,0,0,0,1],
[1,0,0,0,0,0,0,1],
[1,0,0,0,0,0,0,1],
[1,1,1,1,1,1,1,1]